11111111111111111111111111111111111111
1C0000000000000C00000C00K0K00K00001101
1010010100100000101001000C000101001101
101001001010101000100100KC000201111101
1P0000000C00C00000K000000CK00K002E1111
11111111111111111111111111111111111111



