11111111111111111111111111111111111111
1C0000000000000C00000C00K0K00K00001101
1010010100100000101001000C000101002201
101001001010101000100100KC0002C1211101
1P0000000C00C00000K000000CK00K021E2221
11111111111111111111111111111111111111



