1111111111111
1P010000000C1
1000011111001
100011K000001
1000000000001
10010000000C1
1000011111001
100011K000001
1000000000001
100100K0000C1
10K0011111001
100011E000001
1111111111111