11111111111111111111111111111111111
1E0000000000000C00000C00K0000K00001
10100101001000001010010000000101001
101001001010101000100100K0000101001
1P0000000C00C00000K0000000000000C01
11111111111111111111111111111111111