1111111111111111111
1E0C000C00000000001
1010100001000010101
1010010100000010101
1P0000C0000000000C1
1111111111111111111
